........
........
..xxx...
..x.xx..
.RS..xx.
......E.
........
